abash			당혹스럽게 하다, 얼떨떨하게 하다
abate			감소시키다, 무효로 하다, 약화시키다, debilitate, reduce
abdicate		포기하다, 퇴위하다, 사퇴하다
aberration		탈선, 정신이상, deviation
abhor			몹시 싫어하다, 혐오하다
abject			비천한, 비열한, 비굴한(사람)
abnegate		포기하다, 버리다, 자제하다, abandon, renounce
abortive		실패한; 유산의, 발육부진의, unsuccessful
abridge			요약하다; 축소하다, 단축하다; 제거하다
absolute		절대의, 무조건의, 전체적
absolve			용서하다, 사면하다, 방면하다, free from blame
abstinent		절제하는, 금욕적인
abstract		추상적인, 이상적인, 난해한
abstruse		난해한, 심오한, hard to understand
abysmal			심연의, 끝없이 깊은, hopeless
accolade		나이트작 수여식; 명예, 표창
accost			다가가서 말을 걸다
acerbic			[맛이] 신, 신랄한
acquiesce		묵인하다; 묵묵히 따르다, comply passively: aquaint-~을 아는, aquire-얻다
acrid			매운, 신랄한, 가혹한
acrimonious		신랄한, 엄한, 호된
acumen			예민, 날카로운 통찰력
acute			날카로운, 민감한
adage			격언, 속담
adamant			단단한, 견고한, 굳센, stubborn
address			[...에게] 말을 걸다, 연설하다‘ [항의 등을]제기/제출하다
adherent		지지자, 당원, 신자; 부착력 있는, 들러붙는, coherent, 응집한, 밀착한
admonish		훈계하다, 충고하다; 경고하다, scold gently
adroit			교묘한, 솜씨있는; 기민한, 영리한, dexterous, +sinister, gauche
adulation		아첨, 추종
adulterate		오염시키다, 더럽히다
adverse			반대의, 거스르는, 어긋나는, 불리한, antagonistic
aesthetic		미의, 심미적인
affable			상냥한, 사근사근한, 붙임성 있는
affectation		pompose, artificial behavior intended to impress
affinity		유사, 친화력, 좋아함
affluent		풍부한, 부유한
agenda			안건, 의사일정
agrarian		토지의, 경작지의, 농업의
aggregate		모으다, 집합하다, 총계가 ...이 되다, congregate, segregate, integrate
agnostic		불가지론자, one who behave that the existence of a god can be neither proven nor disproven
alacrity		민첩, 기민, 경쾌, 소탈함
allege			단언하다; 변명하다, 우겨대다; 진술하다, asset without proof
alleviate		완화하다, 경감하다, relieve
allocate		할당하다, 배분하다, distribute
alloy			합금, 혼합물
allusion		암시, 빗댐, 언급(hint), indirect reference
aloof			멀리 떨어져서, 초연히; 무관심한, 쌀쌀한, 냉담함
altruism		애타주의 이타주의(타인에게 헌신적인)
ambience		환경, 분위기(mood), atmosphere
ambiguous		중의적인, 두 가지 뜻으로 풀이되는; 분명하지 않은, unclear in meaning
ambivalent		아직 결정되지 않은; 중성의, 중립의; 묽은, 시시한, 양면가치의, undecided
ameliorate		개선하다, 개량하다; 좋아지다
amenable		순종하는, 기꺼이 따르는; 쉽게 좌우되는
amenity			쾌적함, 즐거움, 쾌락; 부드러움, 상냥함
amiable			호감을 주는, 상냥한, 애교 있는
amnesty			사면, 대사, 특사; 사면하다
amoral			초도덕의, 도덕과 관계없는
amorous			호색의, 요염한; 반해 있는
amorphous		무정형의, 일정한 형태가 없는, shapeless
anachronism		시대착오, 시대에 뒤떨어진 사람
analogy			유사, similarity
anarchy			무정부, 무질서
anecdote		일화, 기담; 비화
anguish			고통, 번민, 고뇌; 괴로워하다
animosity		적의, 원한, 악의, resentment, hostility
anomaly			변칙, 이상; 예외, 이례
antecedent		선행자, 선례; 조상; 앞서는, 전제의
antipathy		(↔sympathy)반감, 혐오, 불일치; 싫어하는 사람이나 물건
antithesis		정반대
apartheid		인종차별
apathy			냉담, 무관심, lact of interest
aphorism		격언
apocalypse		묵시, 요한계시록, prophetic revelation
apocryphal		[저자, 작품 등의]작자나 전거가 의심스러운; [일반적으로] 가짜의, dubious authenticity
apotheosis		신격화
appease			진정시키다, 달래다, 유화하다; 갈등을 풀다, 양보하다, soothe
appreciate		가격이 오르다, 시세가 오르다; 감사(평가)하다, +depreciate
apprehensive		염려하는, 걱정하는, 이해; comprehension-이해, 내포
approbation		허가, 인가, 면허, approval; aggravate-악화시키다.
appropriate		적당한, 어울리는, 특정한; 전유하다, 충당하다, take without permission
aptitude		적성, 소질, 재능; 적절함, capacity for learning natural ability
arbiter			중재인, 조정자; 결정적 요소
arbitrary		임의의, 독단적인(random), capricious
arcane			비밀의, 불가사이의(mysterious)
archaic			고풍의
archetype		원형(original model)
ardent			열렬한, 열심인, 타는 듯한(↔half-hearted), passionate
arduous			힘드는, 고난의; 끈기 있는, 노력하는, difficult
aristocratic		귀족의
artful			교묘한, 능수 능란한; 인위적인(=crafty, wily, sly)
artifice		고안, 기술, 궁리; 대책, 술책; sacrifice-제물, 희생
ascendancy		우월, 지배권, 주도권; ascend-올라가다, 오르다
ascetic			금욕주의자, 금욕주의의, abstinent
assiduous		근면한, 꾸준히 힘쓰는, 부지런한
assimilate		동화하는, 동질화하다, 소화하다, 이해하다; 흡수하다
assuage			진정시키다, 누그러뜨리다, sooth
astute			기민한, 빈틈없는; 교활한
attrition		마멸, 마찰, 마손, 감소, 축소
audacity		대담; 대담한 행위(= boldness, impertinence)
augment			증가시키다, 늘리다; 늘다, 증대, burgeon, increase, to make bigger
auspicious		길조의, 경사스런, auspices, favorable, pointing a good result
austere			꾸밈이 없는, 간소한, 엄한, 준엄한, 엄격한, stern
autocratic		독재적인
autonomous		자율의, 자치의, 자주적인
avarice			탐욕, 허욕(=greed)
avow			공언하다, 솔직히 인정하다, claim, admit
avuncular		백부(숙부)의; 삼촌, like an uncle
awry			굽어서; 잘못되어; 휘어서; 틀려서, wry
axiom			원리, 이치, 공리, 격언
banal			평범한, 진부한, ordinary
bane			독, 해악, 파멸의, 원인
bastion			요새(본거지), 능보
beget			아이를 낳다, 생기게 하다, get birth to, create, cause
belabor			세게 때리다, 공격하다, 호되게 꾸짖다, 욕하다, 조롱하다
beleaguer		에워싸다, 포위하다, 괴롭히다, beset
belie			거짓 전하다, 속이다, 숨기다; betray-속이다, 무심코 드러내다
belittle		작게 하다, 경시하다, 과소평가하다
belligerent		교전중인, 호전적인, 싸우기 좋아하는; 교전국, 싸움 상대, 적
bemused			멍하게 하다, ...의 마음을 사로잡다, confused
benefactor		은인, 후원자, 기부하는 사람, +malefactor
benevolent		인정이 많은, 자비로운, 선의의, 호전적인, malevolent
benign			온화한, 친절한, 자비로운, 자상한, malign
bequest			유산, 유물
bereft			[죽음을 통하여 생명, 희망 등을]빼앗기다, 황량해지다; beleave-앗아가다, 잃게하다
beset			에워싸다, 포위하다; 괴롭히다, beleaguer
blasphemy		신성모독, 불경
blatant			소란스러운, 몹시 떠들썩한, 뻔뻔스러운, unpleasantly or offensively noisy
blight			식물의 고조병, 충해; 악화, 황폐
blithe			즐거운, 명랑한, 경솔한
bourgeois		중산계급, 자본가, 부르조아; 고상하지 못한, 속물적인
bovine			소의, 소 같은; 둔한, 둔감한
brevity			간결, 간략, 짧음
broach			끄집어내다, 화제 등을 입밖에 내다, open up a subject for discussion
bucolic			목가적인, 양치기의, 소박한; 목가, 전원시
bureaucracy		관료정치(제도, 주의)
burgeon			성장하다, 갑자기 커지다, augment, expand, flourish
burlesque		광시, 해학극, 익살극, 풍자문, 풍자시
cacophony		불협화음, 불쾌한 음조, 소음
cadence			운율, 억양, 가락
cajole			부추기다; 감언이설로 속이다, 꾀다
callow			아직 깃털이 나지 않은, 풋내기의
candor			정직, 공평무사
capitalism		자본주의
capitulate		항복하다, 성을 내어 주다; recapitulate-summerize
capricious		변덕스런, 마음이 변하기 쉬운, 불규칙한
caricature		만화, 풍자만화, 풍자한 글
castigate		가책하다, 혹평하다; 징계하다; 고치다, 첨삭하다, criticize
catalyst		촉매, 촉진제
categorical		절대적인, 무조건의 단언적인; 범주에 속하는, 분류의
catharsis		정화, 카타르시스
catholic		[관심, 흥미, 취미가] 광범위한, 보편적인; 관대한, 마음이 넓은
caustic			부식성의, 신랄한, 통렬한
celibacy		독신, 독신생활, 금욕
censure			비난하다, 나무라다, 혹평하다, 견책하다
cerebral		대뇌의, 뇌리; 지적인, 지성에 호소하는
chagrin			유감, 원통함, 분함
charisma		재능, 권능; 권위, 비상한 매력
charlatan		지독한 허풍선이, 엉터리의; 돌팔이 의사
chasm			깊게 갈라진 틈, 금, 균열; 단절, 결합; 차이, 불화
chastise		응징하다, 징벌하다; 몹시 비난하다
chicanery		꾸며댐, 발뺌, 속임수
chimera			망상, 괴물
choleric		성마른, 화 잘 내는, bilious, irasible, hot-tempered
chronic			만성의 고질적인, 오래 끄는
chronicle		연대, 편년사, 기록
circuitous		우회의, 에두르는, 완곡한(roundabout)
circumlocution		완곡한 표현, 넌지시 하는 말, 핑계
circumscribe		...의 둘레에 선을 긋다, 경계선을 긋다; 제한하다, 한계를 정하다; 외접하다
circumspect		신중한, 용의주도한, 주의 깊은
circumvent		우회하다, 교묘하게 회피하다; 앞지르다, 선수치다; 포위하다, frustrate as though by surrounding
civil			시민의, 민간의
clandestine		비밀의, 은밀한
clemency		(기후의) 온화; 관대, 인정많은
cliche			진부한 표현, 상투적인 문구
clique			도당, 파벌
coalesce		연합하다, 유착하다; 연합시키다
coerce			지배하다, 강제하다, 강요하다, compelling; coarce-조잡한, 거친
cogent			유력한, 사람을 수긍시키는
cognitive		인식의, 인식력이 있는
cognizant		인식하고 있는, 알고 있는
coherent		일관된, 조리가 서는; 응집성의, 밀착한
colloquial		구어체, conversational
collusion		공모, 결탁, conspiracy
commensurate		같은 양의, 같은 시간의; 균형 잡힌, equal, proportionate
compelling		...하지 않을 수 없는, 강제적인, coerce
compendium		개략, 요약, 일람표
complacent		자기 만족의, 은근한, 마음에 흡족한
complement		보충하여 완전케하다, 보완하다, 보충하다, complete; compliment-경의,아첨
complicity		공모, 연루, 공범
comprehensive		포괄적인; 이해력이 있는, 이해가 빠른; apprehensive-이해하는,우려하는
comprise		포함하다, 품다, 의미하다; 구성되다, 성립되다; apprise-알리다
conciliatory		타협적인, 융화적인, 회유적인
concise			간결한, 간명한
concord			의견의 일치, 화합, 협조; 협정(harmony, agreement)
concurrent		동시에 일어나는, 협동의
condescend		겸손하게 굴다, 자신을 낮추다
condone			용서하다, 묵과하다
conducive		도움이 되는, 이바지하는
confluence		합류, (사람 등의) 집합, 군중, flow together
congenial		같은 성질의, 마음에 맞는, 적합한, 붙임성 있는
congenital		선천적인, 타고난
conjecture		추측하다, 짐작으로 말하다; 억측/판독하다
conjure			마술로 ..하다, 마음속에 그려내다, (영혼을)불러내다; abjure-맹세코 버리다
connoisseur		(미술품 등의) 감정가, 감식가
consecrate		신성하게 하다, 정화하다, 전념하다, 봉헌하다
consensus		일치, 여론, 교감
consonant		조화하는, 일치하는; 협화음의
construe		해석하다, 추론하다, interprct
consummate		완성한, 완성된, 순전한; 터무니없는, 엄청난; 완성하다, 성취하다, perfect
contentious		다투기 좋아하는, 논쟁을 불러일으키는; 소송의
contiguous		접촉하는, 인접하는, 근접한
contingent		불시의, 우연의; ...조건으로 하는, 불확실한, 있을 수 있는; stringent-엄중한,절박한, astringent
contrite		회개한, 회한의, 죄를 뉘우치는
contrived		고안한, 발명한, contrive
conventional		전통적인, 인습적인; 협정상의; 형식적인, 상투적인
convivial		환락의, 연회의; 명랑한
copious			풍부한, 지식이 풍부한; 대량의
corollary		추론, 당연한 결과, something that follows
corroborate		확실히 하다, 입증하다; 확인하다
cosmopolitan		전 세계적인, 세계주의의, 전세계적으로 분포하는
countenance		용모, 안색, 표정; 후원, 지지; 냉정, 침착, face, facial expression
coup			쿠데타, 타격; 대성공, 큰 히트
covenant		계약, 서약, 맹약; 계약의 부대 조항, 날인 증서(계약), contract
covert			비밀의, 암암리의, 덮여 있는, 사람 눈에 띄지 않는
covet			탐내다, 선망하다; 갈망하다, 열망하다
credulous		쉽게 믿는, 겸손하게 믿어 버리는, 속아넘어가기 쉬운
criterion		표준, 기준 규범, standard
cryptic			비밀의, 수수께끼같은, 신비스러운(mysterious); 몸을 숨기기에 알맞은
culinary		요리용의, 주방의, gastronomy
culminate		정점에 이르다, 자오선상에 이르다, 끝나게 하다, climax
culpable		비난할 만한, 과실이 있는, 유죄의, 괘씸한, guilty
cursory			엉성한, 피상적인, 대강대강한
curtail			간략하게 하다, 절감하다, ...에게서 일부를 빼앗다
cynic			냉소하는 사람, 비고는 사람, 빈정대는 사람
daunt			...의 기세를 꺾다, 으르다, 주춤하게 하다, make fearful, intimidate
dearth			부족, 결핍; 기근, scarce
debacle			강 얼음의 깨짐, 시세의 폭락, 와해, 패주; 대홍수
debauchery		방탕, 도락, 주색에 빠짐; 유흥, 야단법석, 난행, wild living
debilitate		쇠약하게 하다, attenuate, tenuous
decadent		쇠퇴기에 접어든, 퇴폐적인, decaying
decimate		많은 사람을 죽이다; 10분의 1을 제거하다
decorous		예의 바른, 점잖은; 단정한; 기품이 있는, 근엄한
deduce			연역하다, 추론하다; 유래를 찾다, 가계를 더듬다
defame			명예를 훼손하다, 비방하다, libel, slander
deference		복종, 존경, 경의, respect
definitive		결정적인, 최후적인; 일정한, 명확한; 한정된
degenerate		퇴보하다, 나빠지다; 타락하다; 퇴화하다; 변질하다
deleterious		해로운, 유독한
delineate		윤곽을 그리다, 묘사하다
delude			속이다, 속이어 ...시키다; 속여서 믿게 만들다, deceive
deluge			대홍수, 범람, 호우; (방문객, 편지 등의)쇄도, flood
demagogue		선동자, 선동 정치가
denizen			주민, 거주자; 귀화인, 국적 취득자, 서식 동물
depravity		부패, 악행, 비행, extreme corruption
deprecate		비난하다, 반대하다, 불찬성을 주장하다
deride			조롱하다, 비웃다
derogatory		손상시키는, 가치를 떨어뜨리는; 경멸적인, degrading
desiccate		건조시키다, 말려서 보존하다
despondent		낙담한, 기운없는, depressed
despot			독재자, 폭군, 전체군주, autocrat
destitute		빈곤한, 결핍한, extremely poor
desultory		산만한, 일관성 없는; 탈선적인, 주제를 벗어난, digress, without a plan or purpose
dialectical		방언의, 변증법의
dictum			격언, 금언; 공식 견해, 언명
didactic		가르치기 위한, 교훈적인
diffident		자신 없는, 사양하는; 겂많은, 내성적인, 수줍은, timid
digress			본제를 벗어나다, 지엽으로 흐르다, 탈선하다, desultory, deviate, stray
dilettante		아마추어 애호가, 어설픈 지식을 가진 사람
discern			분별하다, 식별하다, 인식하다, have insight
discreet		분별있는, 생각이 깊은
discrete		별개의, 구별된, 떨어져 있는, 불연속성의, 개별의
discriminate		구별하다, 판별하다; 차별하다
disdain			경멸, 모멸, 오만, contempt
disinterested		무관심한, 냉담한; 사욕이 없는, 청렴한; 공평무사한
disparage		얕보다, 깔보다; 비방하다, 명예를 해치다
disparate		본질적으로 다른, 공통점이 없는, different
disseminate		선전하다, 널리 흩뿌리다; 보급하다, 퍼뜨리다
dissipate		흩뜨리다, 방산하다, 낭비하다, 일소하다
dissolution		용해, 분해; 해산, 소멸, 사멸
distend			부풀리다, 팽창시키다; 과장시키다, swell
distinguish		구별하다, 분별하다; 눈에 띄게 하다
docile			유순한, 온순한, 착한; 가르치기 쉬운, 다루기 쉬운
doctrinaire		공론적인, 교조주의의(dogmatic)
dogmatic		독단적인, 고압적인; 교의의, 교리의
domestic		가정의, 집의; 국내의, 자국의; 국산의; 길들여진
dormant			동면의, 잠자는; 잠복의, 휴지한; 미발동의, inactive
dubious			의심스러운, 수상한; 모호한, 불안한; 망설이고 있는, uncertain
duplicity		이중성, 표리부동
ebullient		원기 왕성한, 기운이 내뻗는; 열광적인; 액체가 끓는, 끓어 넘치는, boiling
eccentric		편심적인, 정상을 벗어난; 보통과 다른; 괴상한, 별난
eclectic		절충하는, 얽매이지 않는, 다방면에 걸친
edify			품성을 높이다, 교화하다, 함양하다, enlighten, instruct
efface			지우다, 없애 버리다; 말살하다, 소멸시키다
effusion		유출, 분출, 유출물, 분출물; 감정의 표현, erupt
egalitarian		인류 평등주의의
egocentric		자기 중심적인, 자기 본위의
egregious		엄청난, 터무니 없는, 어처구니없는, extremly bad, flagrent
elicit			꾀어내다, 유도하다; 끌어내다, 알아내다, extract, bring out, call forth
elliptical		생략의, 타원의, oval
elusive			교묘히 빠져나가는, 잘 잊는, 알 수 없는; 정의하기 힘든, 외우기 힘든, elude, evade, oblivious, hard to in down
emigrate		타국으로 이주하다, 이주시키다
eminent			탁월한, 뛰어난; 유명한, 저명한, 현저한
empirical		경험적인, 경험의; 실험으로 증명할 수 있는; 경험주의의
emulate			경쟁하다, 다투다, 겨루다, strive to equal through imitation
encroach		서서히 침입하다, 잠식하다; 침범하다, 침해하다, trespass
endemic			한 지역 고유의, 풍토병의
enervate		힘을 빼앗다, 쇠약하게 하다
enfranchise		선거권을 주다, 공민권을 주다, 노예를 해방하다
engender		발생케하다 일으키다; 생기다, 일어나다
enigma			수수께끼, 불가사의한 인물
enormity		무법, 무도, 극악; 범죄 행위, evil, immensity
ephemeral		덧없는, 하루살이의
epigram			경구, 풍자시
epitome			개요, 요약, 축도, 줄거리; 발췌, compendium
equanimity		냉정, 침착
equitable		공정한, 공평한, 이치에 닿는, fair
equivocal		모호한, 의심스런, 분명하지 않은
erudite			박식한, 유식한; 서적 등의 학문적인
esoteric		심원한, 난해한, 비법의, 비밀의
espouse			지지하다, 옹호하다, advocate
ethereal		천상의(heavenly), 공기같은, 가벼운, +corporeal
euphemism		완곡어법
evanescent		차츰 사라지는, 덧없는
exacerbate		병 등을 악화시키다, 더하게 하다; 신경질나게 하다, aggravate
exacting		엄한, 가혹한, 착취적인, 힘든
exalt			높이다, 승진시키다, 칭찬하다, 강렬하게 하다, raise high
exasperate		노하게 하다, 분개시키다, 악화시키다, 더하게 하다
exemplify		예증하다, ...의 모범이 되다
exhaustive		전부를 다하는, 철저한, 포괄적인, 소모적인, 고갈시키는
exhort			간곡히 타이르다, 권하다, 훈계하다, expositulate; cohort-무리
exigency		위급, 긴급한 상태
existential		존재에 관한, 실존의, 실존주의의
exonerate		용서하다, 구하다, 무죄로 하다, free from blame, exculpate
expatriate		국외로 추방하다, 조국을 버리다
expedient		편리한, 유리한, 임시 방편의
expedite		재촉하다, 촉진하다; 군대 등을 파견하다, 공문 등을 급송하다
explicit		명백한, 뚜렷한; 노골적인, 솔직한, 터놓은
extol			칭찬하다, 극찬하다
extraneous		불필요한; 부적절한; 밖의, 외부로부터의; 본질에서 벗어난
extrapolate		통계에서 외삽법에 의해 추정하다, 외삽법을 행하다; 추론하다
extricate		구출하다, 탈출하다, 유리시키다, free from difficulty
extrovert		외향적인 사람, gregarious
exult			크게 기뻐하다, 기뻐 날뛰다, 의기 양양히 하다, ...에게 승리하다
fabrication		꾸밈, 날조; 제작; 조립, 조립부품, figment
facetious		익살맞은, 우스꽝스러운
facile			손쉬운, 용이한, 간편한; 경쾌한, 씩씩한; 솜씨좋은, 피상적인, facility, expedient
faction			도당, 파벌 싸움, 당파성; fraction-파편,단편
farcical		익살극의, 익살맞은, 바보스런, absurd, ludicrous
fastidious		까다로운, 세심한 주의가 필요한, metichlous
fatalist		운명론가
fatuous			바보의, 얼빠진; 실체가 없는, 공허한, fatuity
fauna			동물군, 동물의(animal), flora
fecund			다산의, 상상력이 풍부한, (토지가) 기름진
felicity		지복, 더 없는 행복, 교묘함, 멋들어진 표현, 경사, felicitous; felicitate-축하하다
fervor			열정, 백열, 염열(ardor)
fetter			속박하다, 족쇄를 채우다
fidelity		충실, 정절, 신빙성
figurative		비유적인, 수식이 많은; 상징적인; 조형적인, 구상적인
finesse			솜씨, 교묘한 기교, 술책, 책략, 예리함
flagrant		악명 높은, 극악스런, 명백한
flaunt			자랑하다, 과시하다; 우롱하다; 허영을 부리다
flout			비웃다, 조롱하다, jeer
foible			약점, 결점; 자만하고 있는 점; 칼이 휘는 부분(칼의 가운데서 칼 끝까지), flaw
foment			찜질하다, 조장하다, 선동하다, agitate; torment-괴롭히다
forbear			억제하다, 참다, 아끼다; 삼가다, 몸을 사리다
forgo			보류하다, ...없이 지내다, 무시하다
forsake			버리다, 버리고 돌보지 않다, renounce, relinguish
fortuitous		우연의 행운의
founder			배가 침몰하다, 좌절하다, 실패하다, 침수시키다
fraternal		형제의, 우애의
frenetic		발광한, 열광적인, frantic; forensic-법정의,토론의
frugal			검약한, 검소한; 비용이 들지 않는, 간소한
furtive			은밀한, 교활한, 수상쩍은, insidious, secretive
futile			쓸데없는, 효과없는; 알맹이 없는, 시시한, useless
garrulous		수다스러운, 장황한, 졸졸한 소리를 내는, 시끄럽게 지저귀는
genre			장르, 유형, 약식; 풍속화
genteel			품위 있는, 우아한; 유행을 쫓는; 집안이 좋은
gesticulate		손짓으로 의사소통하다, 손짓을 통해 의사소통을 하다
glut			너무 많은, 차고 넘침, 포만, 과식
grandiloquent		호언 장담하는, 과장하는
grandiose		웅장한, 장엄한, 젠체하는 거드름 피우는
gratuitous		무료의, 무보수의; 이유없는, 불필요한, gratis; gratuity-부조
gravity			진지함, 위엄, 장중함; 중대함; 중력
gregarious		군거하는, 군립성의; 사교적인; 무리의, 군집의, sociable
guile			교활, 음흉한 꾀, 배반심, 책략
hackneyed		낡아빠진, 진부한
hapless			운이 나쁜, 불행한(unlucky)
harbinger		선구자, 전조; 선구가 되다
hedonism		쾌락주의
hegemony		패권, 주도권, leadership
heresy			이단, 이교
hermetic		밀봉한, 밀폐한, 연금술의, 신비한, 연금술사, impervious
heyday			전성기(prime)
hiatus			틈, 갈라진 틈; 탈락, break, interruption
hierarchy		성직자 계급제도, 성직자 정치; 분류 체계, 계층
histrionic		연극의, 연극 배우의; 배우, 연극, overly dramatic
homily			훈계, 설교, sermon
homogeneous		동질의, 같은 종류의(uniform)
husbandry		농업, 절약
hyperbole		과장법; 과장, 과대, 과장된 표현(exaggeration)
hypothetical		가설의, 가정적인
iconoclast		우상타파주의자, 구습 타파주의자
ideology		관념론, 이데올로기, 관념형태
idiosyncrasy		특질, 개성, 특이성, 특유의 표현법, 특이체질
idyllic			전원시의, 목가적인, 한가로운
ignominy		모욕, 불명예, 수치스러운 행위, 추행, deep disgrace
illicit			불법의, 불의의, 불륜의
imminent		절박한, 촉박한, 긴급한
immutable		불변의, 변경되지 않는
impartial		공평한, 치우치지 않은
impeccable		결함 없는, 죄가 없는, 비난의 여지가 없는; impecunious-가난한
imperial		제국의, 황제의, 황실의, 장엄한; 거만한, 건방진; 우수한
impervious		물이나 공기, 혹은 광선 따위가 통과하지 않는; 무감각한, 둔감한, hermatic
impetuous		격렬한, 맹렬한; 성급한, impulsive
implement		약속 따위를 이행하다(to carry out), 도구를 주다, 필요한 권한을 주다
impotent		무기력한, 허약한
impugn			비난하다, 공격하다, attact
inane			공허한, 어리석은, 텅빈, silly
inaugurate		취임식을 거행하다, 취임시키다; 새로운 시대를 열다
incandescent		백열의, 빛나는, 백열광을 내는
incantation		자주 반복하는 문구(슬로건)(chant); 주문; 주문을 욈, 마술, chant
incense			몹시 화나게 하다
incessant		끊임없는, 간단없는
incipient		처음의, 발단의, gambit
incisive		날카로운, 가시 돋친, 예리한, 신랄한
incongruous		어울리지 않는, 부조화의; congruous-일치하는, 적합한
incorrigible		선도할 수 없는, 어쩔 수 없는, 제멋대로의, 뿌리깊은
increment		증가, 증진, 이자, 이득
indifferent		무관심한, 아랑곳하지 않는; 대수롭지 않은, 관계없는; 평범한, 공평한
indigenous		토착의, 국산의, 타고난
indigent		가난한, 빈곤한, impecunious
indignant		화난, 분개한, 성난
indolent		게으른, 나태한; 통증이 없는; redolent-향기로운
indulgent		멋대로 하게 하는 관대한, 엄하지 않은
ineffable		말로 표현할 수 없는, 이루 말할 수 없는, 말하기에도 너무 신성한
inept			부적당한, 바보 같은, 어리석은
inert			활발하지 못한, 생기가 없는, 둔한; 활성이 없는
inexorable		용서없는, 무정한, 냉혹한
infamous		수치스러운, 파렴치한, 악명 높은; 지독한; 형편없는
infatuated		얼빠진, 열중한, 현혹한; fatuity-우둔,멍청함, fatuous-우둔한
infer			추리하다, 나타내다, 암시하다
infinitesimal		극히 작은, 무한소의; 극소량
ingenuous		솔직한, 꾸밈없는; 순진한; ingenious-재간있는,독창적인, ingenue-천진한소녀, ingenuity-영리함,창작력
inherent		천부의, 고유의, 타고난; coherent-밀접한, adherent-지지자
injunction		명령, 훈령, 지령, 금지 명령
innate			타고난, 천성적인
innocuous		해가 없는, 독이 없는
inordinate		지나친, 과도한; 무절제한, 불규칙한, 난폭한
insatiable		만족할 줄 모르는, 탐욕스러운
insidious		교활한, 방심할 수 없는; 잠행성의
insinuate		넌지시 비치다, 빗대어 말하다(hind)
insipid			김빠진, 싱거운, 활기 없는 무미건조한, tepid, vapid
insolent		거만한, 오만한, 거드럭거리는, hubris
instigate		충돌질하다, 선동하다, 부추기다
insular			섬의, 섬나라 근성의, 편협한
insurgent		반란자, 모반자, 폭도, 반정부 운동가
integral		완전한, 완전한 것을 이루는데 필수적인
intractable		다루기 힘든, 억척스러운, 고집센, +tractable
intransigent		정치상 비타협적인
intrinsic		본질적인, 고유의
introspective		자기 반성의, 내성적인
inundate		범람시키다, 침수시키다, 밀어닥치다, 쇄도하다
invective		욕설, 악담, 비난
inveterate		뿌리깊은, 상습적인, 만성의
irascible		성급한, 성을 잘 내는
ironic			비꼬는, 풍자적인, 반어적인
irrevocable		취소할 수 없는, 되부를 수 없는; revocable-취소할수있는
itinerant		순회하는, 순방하는, 편력중인, 지방 순회의
judicious		분별이 있는, 사리 분별력이 있는, 현명한
juxtapose		병렬하다, 나란히 놓다
kinetic			운동의, 운동에 의해 생기는; 활동적인, 정력적인
labyrinth		미궁(maze), 미로, 뒤얽힌 사건
laconic			간결한, 말수 적은
lament			슬퍼하다, 애도하다, 한탄하다
lampoon			풍자하다, 비아냥거리다
languish		약해지다, 나른해지다, 쇠해지다; 동경하다; 괴로워하다; 고달픈 생활을 하다
largess			증여, (아낌없이 주는) 선물
latent			숨어 있는, 잠복기의; 잠재적인, 잠재성의
laud			찬양하다, 기리다
legacy			유산(=bequest)
lethargy		혼수상태; 무감각, 무기력, 활발치 못함
levity			경솔, 경솔한 행위, 경거망동
libel			명예 훼손, 중상; 모욕이 되는 것
litigate		소송하다; 제소/논쟁하다; 법정에서 다투다
loquacious		말 많은, 시끄럽게 지저귀는, 시냇물이 졸졸 소리를 내는, garrulous
lucid			맑은, 투명한; 명료한; 빛나는; 명석한
lugubrious		슬퍼하는; 가련한; 애처로운, mourn, bemoan, lament
luminous		빛을내는, 명료한, 이해가 쉬운; 밝은, 총명한
machination		음모, 책모
magnanimous		관대한, 아량이 있는, 도량이 큰
magnate			고관, 부호; 거물, 유력자
malaise			기분이 언짢은, 불쾌
malfeasance		부정행위
malinger		꾀병을 부리다
malleable		펴 늘일 수 있는, 유순한, 온순한, 가르치기 쉬운, pliable
mandate			명령, 지령; 통치, 위임, 직무집행 영장
manifest		명백한, 분명한
manifesto		성명서, 선언서
marshal			정렬시키다, 정돈시키다; 연방 보안관
martial			전쟁의, 군사의; 군인다운; 호전적인, 용감한
martyr			순교자, 희생자; 박해하다, 괴롭히다
matriculate		입학을 허가하다, 입학하다
maudlin			눈물 잘 흘리는, 감상적인, 만취한
maverick		독불장군, 비순종주의자, 무소속 정치가, 고삐 풀린 망아지
maxim			격언, 좌우명, 격률
mediate			중재하다, 조정하다
mellifluous		감미로운, 유창한
mendacious		허위의, 거짓말 잘하는
mendicant		거지(beggar)
mentor			현명하고 성실한 조언자(teacher, tutor)
mercenary		용병, 고용된 사람
mercurial		민활한, 변덕스러운; 명랑한, 쾌활한; 수은의
metamorphosis		형태의 변호, 변태, 변성, 변질
microcosm		소우주, 인간사회
milieu			주위, 환경
minuscule		매우 작은
misanthropic		염세적인, 인간혐오의
mitigate		누그러뜨리다, 달래다, 완화하다; 경감하다
mollify			완화하다, 경감하다, 진정시키다, 달래다
monolithic		단일적인, 획일적인; 완전히 통제된
moribund		죽어가는, 소멸해 가는, defunct, demise
morose			침울한(gloomy, sullen), 뿌루퉁한, 뚱한, 기분이 언짢은
mortify			억제하다, 극복하다, 굴욕감을 주다, 분하게 하다
mundane		        세속의, 현세의, 이승의, 보통의
munificent		인색하지 않은, 아낌없이 주는(lavish), 대범한
myopia			근시안; 선견지명이 부족한
myriad			무수한; 무수한 사람
narcissism		자기도취
nebulous		성운의, 흐린, 불투명한; 애매한, 막연한
nefarious		못된, 악당의, 불법적인
neologism		신어(new word), 신어 사용
nepotism		관직 임용의 친척, 친구 편중
nihilism		허무주의, 무정부주의
nominal			이름의, 이름을 나타내는, 이름뿐인; 액면의
nostalgia		향수; 과거의 동경(homesickness)
notorious		소문난, 이름난, 악명 높은
novel			신기한, 희한한; 새로운, 참신한
noxious			유해한, 해로운; 불건전한, 정신적으로 유해한
nuance			색조, 음영, 농담; 말뜻의 미묘한 차이
obdurate		고집센, 완고한, 냉혹한
obfuscate		마음을 어둡게 하다, 어지럽게 하다; 당황하게 하다, 난처하게 하다
oblique			비스듬한, 기울어진, 사선의; 굽은, 완곡한
oblivion		망각, 건망; 대사면
obscure			분명치 않은, 모호한; 눈에 띄지 않는, 컴컴한, 흐린, nebulous
obsequious		아첨하는, 알랑거리는
obtuse			무딘, 둔한, 머리가 우둔한
officious		참견하기 좋아하는, 부질없이 참견하는, 비공식의
onerous			성가신, 귀찮은
opaque			불투명한, 불분명한; 우둔한, 부전도성의
opulent			부유한, 풍부한
orthodox		전통의, 정통파의, 승인된; 전통적인, 인습적인
ostensible		외면상의, 겉치레의
ostentatious		자랑삼아 드러내는, 겉보기를 꾸미는; 허식적인, 화려한
pacify			달래다, 만족시키다, 진정시키다
painstaking		수고를 아끼지 않는, 근면한(=pains-taking = taking pains)
palliate		임시적으로 완화시키다, 꾸며서 말하다, 변명하다; 변형하다
palpable		만질 수 있는, 뚜렷한, 분명한, touchable; culpable=guilty
paltry			하찮은, 시시한, 무가치한, 얼마 안되는
panacea			만병 통치약
paradigm		모범, 보기; 어형 변화표
paradox			역설, 모순
parochial		편협한; 교구의, 지방의, provincial
parody			풍자 섞인 개작 시문, 서투른 모방
parsimonious		인색한(=stingy)
partisan		도당, 일당, 한 동아리
patent			명백한, 분명한(=obvious)
paternal		아버지의, 세습의
pathology		병리학
patriarch		가장, 족장; 원로, 장로; 로마 교황
patrician		귀족, 문벌가; 고대 로마 귀족
patronize		보호하다, 후원하다; 찬조하다
paucity			결핍, 부족(=scarcity), 소량, 소수
peccadillo		과오, 조그만 결점
pedantic		현학적인, 학자인 체하는
pedestrian		상상력이 없는(unimaginative), 평범한, 진부한(banal)
pejorative		가치를 떨어뜨리는(negative),비난하는(disparaging);cajole-감언으로 속이다
penchant		기호, 경향, 취미; nonchalant=indifferent
penitent		후회하는 참회하는, 죄를 뉘우치는(sorry, repentant, contrite)
pensive			생각에 잠긴, 애수를 띤
peremptory		단호한, 강압적인; 엄연한, 거만한; 독단적인, 단정적인(categorical)
perennial		다년생의, 여러해 계속하는(continual)
perfidy			불성실, 배반(treachery)
perfunctory		형식적인(careless;무관심한), 겉치레의(unenthusiastic), punctilious
peripatetic		순회하는(itinerant), 걸어다니는(wandering), 소요학파의
periphery		주의, 주변; 표면, 외면
perjury			위증, 거짓 맹세
permeate		스며들다, 침투하다, 퍼지다
pernicious		유해한; 파멸적인, 치명적인(deadly)
perquisite		부수입, 팁(=perk)
pertinent		적당한, 적절한, ...에 과한, 관련된(relevant)
perturb			교란하다, 혼란시키다
peruse			정독하다, 숙독하다
pervade			널리 퍼지다, 보급하다, 스며들다, 고루 미치다
petulant		잘 토라지는, 화를 잘 내는, 까다로운(cranky, rude)
philanthropy		박애, 자선; 자선 활동, 자선 사업
philistine		속물, 교양 없는 사람
pious			신앙심이 깊은, 경건한; 종교적인; 위선적인, 종교를 구실로 삼는
pivotal			축의, 중추적인, 중요한(crucial)
placate			회유하다, 달래다, 위로하다; 가라앉히다, 삭이다
plaintive		슬픈 듯한, 구슬픈, 불쌍한, 애처로운
platitude		진부한, 평범한; 단조; 진부한 말, 흔해 빠진 발언
plebian(plebeian)	보통의, 평범한; 속된(vulgar), 천한
plethora		과다, 과잉, +scarce
poignant		신랄한, 날카로운; 감동적인, 마음에 강하게 호소하는
polarize		극성을 주다, 양극화하다; 대립시키다, 분열하다
polemic			논쟁, 논법
ponderous		육중한(massive),  다루기에 불편한, 답답한, 지루한(dull), 장황한, 어색한
portent			전조; 징조; 경이적인 것(사람)
postulate		가정, 선결 조건, 기본 원리, 필요조건; 원리, 이치
pragmatic		실용적인, 실용주의의
precedent		선례, 관례, 판례
precept			교훈, 격언(maxim); 법칙, 영장, 명령서
precipitate		갑자기 빠뜨리다, 곤두박질치게 하다, 촉진시키다, 재촉하다
precipitous		가파른, 험한(steep); 황급한, 허둥대는
preclude		제외시키다, 배제하다; 방해하다, 가로막다
precursor		선임자, 선배, 선구자, 선각자
predilection		편애, 역성
preeminent		탁월한, 발군의, 현저한, 출중한
preempt			선매권에 의해 얻다
premise			전제, 전술한 사항, 근거; 토지, 부동산; surmise-짐작하다,추측하다.
prepossess		선입관을 가지게 하다; 좋은 이상을 주다, 호감을 가지게 하다
prerogative		특권, 특전; 우선 투표권
prevail			우세하다, 널리 보급하다; 유력하다, 압도하다, prevalent
pristine		원시적인, 옛날의, 원래의, 순박한
prodigal		풍부한, 남아도는; 낭비하는, 방탕한
prodigious		거대한, 막대한; 비범한, 유별난, 비상한
prodigy			경이, 비상한 일, 이상한 조짐, 전조
profane			모독적인 신성을 더럽히는; 세속의, 야비한
profess			공언하다, 단언하다, 주장하다; 속이다
proficient		숙달된, 유창한, 능숙한
profligate		방탕한, 낭비하는
profound		깊은, 뿌리 깊은; 심원한, 해박한, 난해한
profuse			아낌없는, 마음이 후한; 풍부한, 많은; 과다한
proletariat		무산계급, 최하층민
proliferate		증식하다, 확산하다
prolific		다산의, 비옥한, 다작의, 풍부한
promulgate		공포하다, 터뜨리다, 널리 펴다, 선전하다, 보급하다
propensity		경향, 성향, 성벽, 성질, penchant
propitious		순조로운, 상서로운, 자비로운; 좋은, 호의를 가진
proponent		옹호자, 지지자; 제안가, 제의자
proprietary		소유가의, 독점의, 점매 특허의; 재산 있는
propriety		타당, 정당; 예의바른, 교양
prosaic			산문적인, 평범한, 지루한, prose
proscribe		금지하다, 배척하다, 추방하다; 인권을 박탈하다
proselytize		개종시키다, 전향시키다
protagonist		주인공, 주역, 주창자
protract		오래 끌게 하다, 연장하다, 뻗다, 내밀다(prolong)
provident		신중한, 선견지명이 있는; 검소한
provincial		편협한; 지방의, 시골의; 옹졸한, 투박한
provisional		잠정적인, 일시적인, 임시의
proximity		근접, 인접, 가까운
prudent			신중한, 현명한, 검약하는, 빈틈없는
purported		의미하다, 뜻하다; ~라고 칭하다, 주장하다
putative		추정의, 상상의, 소문에 들리는
qualify			제한하다, 한정하다, 완화하다; 자격을 주다, 권한을 부여하다
qualitative		질적인, 질에 관한
querulous		불평을 하는, 투덜거리는; 성마른
quixotic		공상가의, 비실행적인
ramification		결과, 귀추; 가지, 분기, 분리; 세부화
rancor			원한, 증오, 유감
rapacious		강탈하는, 약탈하는, 욕심많은
rebuke			비난하다, 억제하다
rebut			논박하다, 반증하다; refute-반박하다
recalcitrant		반항하는, 고집센, 완강한
recant			신앙이나 주장 등을 바꾸다, 취소하다, 철회하다
reciprocal		상호간의(mutual), 호혜적인, 보복의, 보답의
reclusive		세상을 버린, 은둔한, 쓸쓸한, recluse
recondite		심오한, 난해한, 알기 어려운
recrimination		서로 책망함, 빈소, 전가, 맞고소
redolent		향기로운(fragrant); indolent-게으른
redundant		여분의, 과다한, 장황한
refute			논박하다, 반박하다
reiterate		되풀이하다, 반복하다
relegate		내쫓다, 추방하다, 물리치다			
relentless		냉혹한, 잔인한, 사정없는
relinquish		포기하다, 단념하다, 손을 떼다, 그만두다, renounce
remonstrate		항의하다, 이의를 말하다, 간언하다
renaissance		부활, 신생, 부흥
renounce		포기하다 단념하다, 중지하다
reparation		보상, 배상; 수리, 수선
repercussion		되튀기, 반사, 반향, 반동, 반격
replenish		다시 채우다, 새로 보충하다
replete			가득찬, 충만한; 포식한, 배부른, 포만한
reprehensible		비난할 만한, 꾸짖을 만한, 괘씸한; apprehensible, comprehensible
reprisal		보복, 앙갚음, 복수; 실력 행사
reproach		비난하다, 나무라다, 꾸짖다; 체면을 손상시키다
reprove			비난하다, 꾸짖다, 타이르다, 야단치다
repudiate		거부하다, 거절하다, 부인하다
requisite		필요한, 필수적인, 필수의
resolute		굳게 결심한, 굳은, 단호한, 확고한; resolution-분해,분석,해결
respite			연기, 일시적 중단, 유예; 휴식기간
reticent		과묵한, 입이 무거운, 삼가는
revere			존경하다, 숭배하다
rhetoric		수사학, 웅변술, 미사여구, 작문법
rigorous		엄격한, 호된, 엄한; 엄밀한, 정확한
robust			건강한, 튼튼한, 강건한, 건전한
rogue			건달, 깡패; 개구장이, 부당한
rudimentary		기본의, 초보의; 미숙한, 원형의
ruminate		반추하다, 심사 숙고하다, deliberate, cogitate
rustic			시골풍의(rural), 시골의, 소박한, 단순한
saccharine		달콤한, 설탕 같은
sacrilege		신성 모독의
sacrosanct		신성한, 신성 불가침의
sagacious		현명한, 기민한, 총명한
salient			두드러진, 현저한; 돌출한, 원기 왕성한
salutary		건전한, 유익한
sanctimonious		경건한 체하는
sanguine		붉은 빛을 띤, 다혈질의, 혈색이 좋은, 쾌활한, 살벌한
sardonic		냉소하는, 빈정대는
scintillate		불꽃을 내다, 재치가 번득이다
scrupulous		빈틈없는, 면밀한; 양심적인, 지조있는, 신중한
scrutinize		자세히 조사하다, 속속들이 알아보다
secular			세속의
sedition		반역죄(treason); 치안 방해죄, 동란 교사죄, treacher
sensory			지각 기관의, 감각을 전달하는; precurser-선조, cursory-겉모습의
sentient		지각 있는, ...을 느낄 수 있는
sequester		은퇴시키다, 고립시키다; 몰수하다, 가압류하다
serendipity		뜻밖의 발견, 재수 좋게 찾아 낸 것, contingent
servile			노예 근성의, 비굴한
singular		보통이 아닌, 뛰어난; 유일한(unique), 유례없는
slander			중상하다, 명예를 훼손하다
sloth			게으름
sobriety		절주, 절제, 제정신, 온건
solicitous		간절히 ...하려 하는, 갈망하는; 염려하는, 걱정하는, solicitude, solicit
solvent			지급 능력이 있는, 감정을 누그러지게 하는
soporific		최면에 걸린, 졸리게 하는
sordid			지저분한(filthy, squalid),  누추한, 탐욕스런, 야비한(vile)
spawn			산란하다, 대량 생산하다
specious		허울 좋은, 그럴듯한, 겉만 번드레한
sporadic		때때로 일어나는, 드문드문한, 산발성의
spurious		가짜의(false, fake); auspices-후원,길조
squalor			불결함, 더러움; 천함, 야비함
squander		헛되이 쓰다, 탕진하다, 낭비하다, 분산시키다
stagnation		침체, 불경기
static			정적인, 정지된, 정지 상태의
staunch			견고한, 튼튼한; 믿음직한, 완고한, 확고부동한(steadfast)
steadfast		충실한(loyal, faithful), 확고부동한, 불변의
stigmatize		비난하다, 오명을 씌우다, 낙인을 찍다
stipulate		규정하다, 조건으로 요구(규명)하다
stoic			스토익학파의; 금욕/극기주의
stratum			지층, 사회의 계층(layer, level)
stricture		구속, 협착; 혹평
strife			투쟁, 쟁의, 불화, 반목, 싸움
stringent		엄중한, 절박한, 그럴듯한; contingent-불시의,우연의, astringent
stymie			방해하다, 방해구로 방해하다
subjugate		정복하다, 가라앉히다
sublime			장엄한(lofty), 탁월한, 고상한, 두려움(awesome)
subordinate		종속하는, 부수하는; 아래의, 하위의
substantive		현실의, 독립의; 명사의, 실질적인; substance, substantial, substantiate, substantival, substantion-변전소
subtle			미묘한, 예민한, 교활한, 교묘한
subversive		파괴적인, 전복하는
succinct		간결한
succumb		        죽다, 쓰러지다; 굴복하다, 지다
supercilious		거드름을 피우는, 거만한
superficial		표면적인, 외면의; 피상적인, 허울뿐인; 영향이 적은
superfluous		남아도는, 불필요한
surfeit			과식, 과음, 포만
surreptitious		은밀한, 부정한, 간교한
surrogate		대리의, 대용의, substitute
sycophant		아첨꾼
synthesis		통합, 종합; 합성
tacit			무언의, 암묵적인, 암시하는(implied)
taciturn		말없는, 입이 무거운, 무뚝뚝한
tangential		접선의, 접하는; 탈선적인, 주제를 벗어난, digress
tangible			만질 수 있는(touchable, palpable), 만져서 알 수 있는, 명백한, 확실한
tantamount		동등한, 상당하는
tautological		동의어의, 중언부언의; 과다한(redundant)
temerity		boldness; recklessness; audacity
temperate		기온이 온화한(mild), 온건한, 절제하는
tenable			공격에 견딜 수 있는, 지지 받을 수 있는, 유리할 수 있는
tenacious		고집센(persistent), 몹시 집착하는, 완고한(stubborn)
tenet			종교나 정치 혹은 철학 따위의 주의
tentative		잠정적인, 시험적인, 임시의; 주저하는, 머뭇거리는
tenuous			얇은, 희박한, 가는; extenuate-경감하다
terse			간결한(succinct)
theology		신학, 종교 심리학
tirade			장광설, 신랄한 연설
torpor			무감각, 둔한, 동면
touchstone		금이나 은의 순도를 판별하는 시금석, 표준
tout			...을 극구 칭찬하다, ...에 대해 말하다; 성가시게 권유하다, 조르다, 염탐하다; rout-완패,참패
transcend		초월하다, 능가하다, 우수하다
transgress		범하다, 어기다(violate)
transient		일시적인, 변하기 쉬운
trepidation		공포(fear), 전율, 놀람, 당황
turpitude		비열, 타락, 비열한 행위
ubiquitous		어디에나 있는, 편재하는
unconscionable		불합리한, 터무니없는, 비양심적인
unctuous		기름 같은, 매끈한, 아주 감동한 체하는, 상냥한
uniform			일정한, 균일한(consistent, unchanging)
unremitting		간단없는, 끈질긴
unwitting		무의식의, 생각나지 않는, inconscious
urbane			도시풍의, 점잖은, 세련된
usurp			권력이나 지위를 빼앗다, 찬탈하다, 침해하다
utilitarian		공리적인, 실용적인, 공리주의의
utopia			an ideal society
vacillate		흔들리다, 동요하다; 주저하다, 망설이다
vapid			맛없는, 김빠진, 지루한, tepid, insipid
vehement		열심인, 열렬한, 열정적인, 맹렬한; coherent-밀착한, adherent-지지자
venal			돈으로 좌우할 수 있는, 매수할 수 있는, 매수되기 쉬운; 타락한, 부패한
venerate		존경하다, 공경하다
veracity		진실, 성실, 정직, verity
verbose			말이 많은, 장광설의, 장황한
verisimilitude		진실인 듯한, 있을 법한, 진짜인 것처럼 보이는, 박진성
vernacular		everyday speech; slang; idiom
vestige			자취, 흔적, 퇴화
vex			초조하게 하다, 괴롭히다
viable			생존할 수 있는, 자랄 수 있는
vicarious		대리직의, 대리의, 대리하는, 대신의, surrogate
vicissitude		변화, 부침, 흥망; 변하기 쉬움
vilify			헐뜯다, 중상하다; 타락시키다
vindicate		변호하다, 옹호하다, 진실을 밝히다, 명예를 회복하다; 논박하다
vindictive		앙심을 품은, 복수심을 품은
virtuoso		예술의 거장(대가), 미술에 정통한 사람, 미술품 감정가
virulent		독이 있는, 악의가 있는; 심술궂은, 악성(유독성)의
visionary		공상가, 환상을 쫓는 사람
vitiate			...의 가치를 떨어뜨리다, 손상시키다, 해치다; 무효로 하다
vitriolic		신랄한, 통렬한
vocation		소명, 성직, 천직, 직업; 적성, 소질
vociferous		큰 소리로 고함치는, 시끄러운
volatile		휘발하는, 휘발성의; 변덕스러운, 불안정한; 경박한, 민활한, 쾌활한
volition		의지, 결단력, 의욕
wanton			방자한, 무엄한, 이유가 없는, 터무니없는, 변덕스러운
willful			계획적인, 고의의, 고집센
wistful			탐내는, 동경하는, 생각에 잠긴
zealous			열광적인, 열광하는